R 1000 2000
NO ./textures/north.xpm
SO ./textures/south.xpm
WE ./textures/wall_color_brick.xpm  
EA ./textures/east.xpm
S ./textures/sprite.xpm
F 30,39,54
C 0,64,161
 
        1111111111111111111111111111
        1000200002110200000W000011
        1011002001110202000200001
        1001000000000200020002001
111111111011000001110200000000001
100000000011002001110111111111111
11110111111111011100000010001
 1110111111111211101010010001
11000000110101011100000010001
10002000000000000000000000001
11000020000000001001010010001
11000001110101011111011110001
11110111 1110101 101111010001
11111111111111111111111111111